S # # # # # #
. . . . . # #
# . # # . # #
# . # # . . #
# . . # # . #
# . # # # # #
# . # # . # #
. . . # . . G
# # . . . # #
